1111111111
1000000001
1000000001
10C0P00001
1110000001
1E10000001
1111111111