1111111
10WR001
1000001
1000P01
10C0001
10E0001
1111111