1111111111111
1000000000001
1000000000001
100000000000111
1111111111111