1111111111111111
1000000P00000001
1000111111110001
10001E0000010001
1000100000010001
1000100000000001
1000111111110001
1000000000000001
1C000000000000C1
1111111111111111